width: 29,
height: 31,
grid: [
        [1,1,1,1,1,1,1,1,1,1,1,1,1,1,1,1,1,1,1,1,1,1,1,1,1,1,1,1,1],
        [1,2,2,2,2,2,7,2,2,2,2,2,2,1,1,1,2,2,2,2,2,2,2,2,2,2,2,2,1],
        [1,2,1,1,1,1,2,1,1,1,1,1,2,1,1,1,2,1,1,1,1,1,2,1,1,1,1,2,1],
        [1,3,1,1,1,1,2,1,1,1,1,1,2,1,1,1,2,1,1,1,1,1,2,1,1,1,1,3,1],
        [1,2,1,1,1,1,2,1,1,1,1,1,2,1,1,1,2,1,1,1,1,1,2,1,1,1,1,2,1],
        [1,2,2,2,2,2,2,2,2,2,2,2,2,1,1,1,2,2,2,2,2,2,2,2,2,2,2,2,1],
        [1,2,1,1,1,1,2,1,1,2,1,1,1,1,1,1,1,1,1,2,1,1,2,1,1,1,1,2,1],
        [1,2,1,1,1,1,2,1,1,2,1,1,1,1,1,1,1,1,1,2,1,1,2,1,1,1,1,2,1],
        [1,2,2,2,2,2,2,1,1,2,2,2,2,1,1,1,2,2,2,2,1,1,2,2,2,2,2,2,1],
        [1,1,1,1,1,1,2,1,1,1,1,1,4,1,1,1,4,1,1,1,1,1,2,1,1,1,1,1,1],
        [1,1,1,1,1,1,2,1,1,1,1,1,4,1,1,1,4,1,1,1,1,1,2,1,1,1,1,1,1],
        [1,1,1,1,1,1,2,1,1,4,4,4,4,4,4,4,4,4,4,4,1,1,2,1,1,1,1,1,1],
        [1,1,1,1,1,1,2,1,1,4,1,1,1,5,5,5,1,1,1,4,1,1,2,1,1,1,1,1,1],
        [1,1,1,1,1,1,2,1,1,4,1,4,4,4,4,4,4,4,1,4,1,1,2,1,1,1,1,1,1],
        [1,8,4,4,4,4,2,1,1,4,1,4,6,4,6,4,6,4,1,4,1,1,2,4,4,4,4,8,1],
        [1,1,1,1,1,1,2,1,1,4,1,4,4,4,4,4,4,4,1,4,1,1,2,1,1,1,1,1,1],
        [1,1,1,1,1,1,2,1,1,4,1,1,1,1,1,1,1,1,1,4,1,1,2,1,1,1,1,1,1],
        [1,1,1,1,1,1,2,1,1,4,4,4,4,4,4,4,4,4,4,4,1,1,2,1,1,1,1,1,1],
        [1,1,1,1,1,1,2,1,1,4,1,1,1,1,1,1,1,1,1,4,1,1,2,1,1,1,1,1,1],
        [1,1,1,1,1,1,2,1,1,4,1,1,1,1,1,1,1,1,1,4,1,1,2,1,1,1,1,1,1],
        [1,2,2,2,2,2,2,2,2,2,2,2,2,1,1,1,2,2,2,2,2,2,2,2,2,2,2,2,1],
        [1,2,1,1,1,1,2,1,1,1,1,1,2,1,1,1,2,1,1,1,1,1,2,1,1,1,1,2,1],
        [1,2,1,1,1,1,2,1,1,1,1,1,2,1,1,1,2,1,1,1,1,1,2,1,1,1,1,2,1],
        [1,2,2,2,2,2,2,1,1,2,2,2,2,1,1,1,2,2,2,2,1,1,2,2,2,2,2,2,1],
        [1,2,1,1,1,1,2,1,1,2,1,1,1,1,1,1,1,1,1,2,1,1,2,1,1,1,1,2,1],
        [1,3,1,1,1,1,2,1,1,2,1,1,1,1,1,1,1,1,1,2,1,1,2,1,1,1,1,3,1],
        [1,2,2,2,2,2,2,2,2,2,2,2,2,2,7,2,2,2,2,2,2,2,2,2,2,2,2,2,1],
        [1,1,1,1,1,1,1,1,1,1,1,1,1,1,1,1,1,1,1,1,1,1,1,1,1,1,1,1,1]
	]